abandon	Synonyms:relinquish,forgo,forsake,	
abash	Synonyms:fluster,disconcert,discomfit,discompose,
abdicate	Synonyms:renounce,abandon,relinquish,	
abet	Synonyms:spur,incite,		Antonyms:deter,
abridge	Synonyms:curtail,diminish,retrench,		Antonyms:protract,elongate,amplify,
abrogate	Synonyms:annul,nullify,rescind,void,	
abstemious	Synonyms:temperate,	
academic	Synonyms:scholastic,	
accede	Synonyms:assent,		Antonyms:demur,
accelerate	Synonyms:expedite,		Antonyms:retard,
accolade	Synonyms:tribute,ovation,	
accord	Synonyms:concord,concurrence,		Antonyms:dissension,discord,
acrimonious	Synonyms:caustic,acerb,pungent,tart,mordant,acrid,		Antonyms:suave,affable,
acumen	Synonyms:perspicacity,discernment,perception,		Antonyms:obtuseness,
admonish	Synonyms:chide,caution,reprimand,reprehend,reproach,	
adversary	Synonyms:antagonist,		Antonyms:cohort,confederate,ally,accomplice,
adversity	Synonyms:affliction,mischance,reverses,	
affable	Synonyms:civil,complaisant,benign,gracious,genial,urbane,cordial,		Antonyms:curt,brusque,rude,boorish,surly,
affluent	Synonyms:opulent,profuse,		Antonyms:destitute,impecunious,
aggressive	Synonyms:bumptious,officious,obtrusive,		Antonyms:meek,humble,retiring,diffident,
alacrity	Synonyms:celerity,briskness,energy,animation,		Antonyms:apathy,nonchalance,sluggishness,lethargy,phlegmatism,
allay	Synonyms:appease,alleviate,pacify,assuage,abate,mitigate,propitiate,mollify,placate,		Antonyms:intensify,aggravate,
allude	Synonyms:insinuate,intimate,imply,		Antonyms:refer,cite,
allure	Synonyms:lure,decoy,inveigle,entice,seduce,wheedle,beguile,cajole,		Antonyms:repel,
ambiguous	Synonyms:hazy,obscure,equivocal,dubious,nebulous,		Antonyms:explicit,unquestionable,
amenable	Synonyms:tractable,docile,responsive,		Antonyms:intractable,refractory,recalcitrant,
amiable	Synonyms:complaisant,	
analogy	Synonyms:correspondence,affinity,		Antonyms:anomaly,
anarchy	Synonyms:chaos,pandemonium,	
animus	Synonyms:enmity,rancor,malevolence,animosity,		Antonyms:amity,
apathy	Synonyms:torpor,lethargy,sluggishness,listlessness,languor,lassitude,dispassion,		Antonyms:zeal,animation,
approbation	Synonyms:sanction,commendation,		Antonyms:disapprobation,
apt	Synonyms:prone,		Antonyms:inept,
arbiter	Synonyms:mediator,arbitrator,	
archetype	Synonyms:prototype,		Antonyms:Stereotype,facsimile,replica,
arid	Synonyms:jejune,parched,		Antonyms:arable,fertile,
aristocracy	Synonyms:oligarchy,		Antonyms:democracy,
armistice	Synonyms:truce,	
artful	Synonyms:cunning,wily,adroit,ingenious,guileful,		Antonyms:guileless,ingenuous,artless,
ascetic	Synonyms:austere,abstinent,		Antonyms:wanton,
asseverate	Synonyms:assert,avouch,aver,avow,allege,		Antonyms:gainsay,controvert,recant,rescind,abjure,disavow,
assiduous	Synonyms:sedulous,attentive,diligent,indefatigable,		Antonyms:indolent,slothful,
asylum	Synonyms:sanctuary,refuge,	
atheist	Synonyms:infidel,agnostic,skeptic,	
attribute	Synonyms:ascribe,	
augment	Synonyms:enhance,amplify,		Antonyms:abate,curtail,
auspicious	Synonyms:propitious,fortunate,		Antonyms:ominous,foreboding,
authentic	Synonyms:veritable,bona fide,		Antonyms:apocryphal,counterfeit,spurious,bogus,
autocratic	Synonyms:tyrannical,		Antonyms:benevolent,
avarice	Synonyms:covetousness,cupidity,avidity,		Antonyms:magnanimity,
awry	Synonyms:askew,	
banal	Synonyms:commonplace,hackneyed,prosaic,trite,stereotyped,vapid,		Antonyms:racy,original,vivid,
baneful	Synonyms:deleterious,pernicious,virulent,noxious,toxic,		Antonyms:beneficent,
banter	Synonyms:raillery,chaff,	
belie	Synonyms:misrepresent,	
bellicose;	Synonyms:pugnacious,contentious,disputatious,		Antonyms:pacific,conciliatory,
benevolent	Synonyms:benign,benignant,gracious,magnanimous,		Antonyms:malevolent,malignant,
besmirch	Synonyms:stilly,defile,smirch,bespatter,	
biased	Synonyms:bigoted,arbitrary,partial,partisan,		Antonyms:disinterested,equitable,
bibliophile	Antonyms:bibliophobe,
bizarre	Synonyms:odd,fantastic,grotesque,eccentric,	
bland	Synonyms:mild,suave,soothing,		Antonyms:piquant,tart,racy,caustic,acrid,pungent,
blight	Synonyms:wither,blast,	
blithe	Synonyms:jocund,merry,joyous,		Antonyms:dejected,forlorn,abject,
bog	Synonyms:morass,fen,quagmire,mire,	
bombastic	Synonyms:ranting,pompous,fustian,	
boorish	Synonyms:churlish,uncouth,uncultured,crass,		Antonyms:suave,
bucolic	Synonyms:pastoral,rustic,rural,	
buffoon	Synonyms:harlequin,	
bulwark	Synonyms:rampart,	
bumptious	Synonyms:aggressive,arrogant,contumelious,overbearing,	
cabal	Synonyms:junto,faction,	
cacophonous	Synonyms:dissonant,discordant,blatant,strident,raucous,		Antonyms:mellifluous,euphonious,dulcet,
cadaverous	Synonyms:ghastly,gaunt,pallid,wan,ashen,		Antonyms:rubicund,florid,
callous	Synonyms:insensible,obdurate,	
calumniate	Synonyms:asperse,vilify,defame,scandalize,	
candid	Synonyms:artless,ingenuous,unbiased,		Antonyms:guileful,evasive,
cantankerous	Synonyms:petulant,peevish,contentious,pugnacious,testy,choleric,fretful,		Antonyms:amiable,affable,equable,
capricious	Synonyms:fickle,fitful,changeable,erratic,inconstant,crotchety,whimsical,mercurial,		Antonyms:steadfast,constant,
captious	Synonyms:hypercritical,carping,carviling,censorious,	
castigate	Synonyms:reprove,upbraid,reprehend,censure,reprimand,chasten,		Antonyms:commend,eulogize,laud,
celestial	Synonyms:ethereal,	
chauvinist.	Synonyms:jingoist,	
chicanery	Synonyms:duplicity,craft,stratagem,wile,subterfuge,	
chronic	Synonyms:persistent,unremitting,inveterate,incessant,constant,		Antonyms:intermittent,sporadic,infrequent,
circumspect	Synonyms:prudent,vigilant,discreet,wary,		Antonyms:rash,indiscreet,reckless,precipitate,foothardy,temerarious,headstrong,
circumvent	Synonyms:thwart,balk,outwit,delude,	
civil	Synonyms:respectful,gracious,	
clamorous	Synonyms:vociferous,obstreperous,blatant,raucous,strident,		Antonyms:muted,quiet,
clandestine	Synonyms:furtive,covert,surreptitious,		Antonyms:overt,manifest,
clement	Synonyms:compassionate,forbearing,		Antonyms:relentless,ruthless,
coalition	Synonyms:amalgamation,consolidation,fusion,	
coercion	Synonyms:constraint,restraint,impelling,	
cogent	Synonyms:persuasive,	
collusion	Synonyms:collaboration,conspiracy,conniving,machination,	
commodious	Synonyms:spacious,capacious,ample,	
compatible	Synonyms:congruous,consistent,		Antonyms:incongruous,discordant,incompatible,
compendium	Synonyms:synopsis,digest,precis,abstract,epitome,	
compensation	Synonyms:stipend,remuneration,recompense,emolument,	
complacent	Synonyms:smug,	
compunction	Synonyms:contrition,penitence,atonement,remorse,qualm,	
concede	Synonyms:acquiesce,capitulate,	
condole	Synonyms:commiserate,show compassion,solace,	
condone	Synonyms:extenuate,palliate,mitigate,gloss,	
confederate	Synonyms:collaborator,accomplice,	
congenial	Synonyms:compatible,	
conjecture	Synonyms:surmise,presume,	
consecrate	Synonyms:hallow,sanctify,		Antonyms:desecrate,
consensus.	Synonyms:accord,	
consternation	Synonyms:dismay,bewilderment,	
consummate	Antonyms:botched,inept,
contemptuous	Synonyms:supercilious,scornful,disdainful,contumelious,	
convivial	Synonyms:jovial,jocund,mirthful,		Antonyms:lugubrious,dolorous,mirthless,
copious	Synonyms:profuse,bountiful,abundant,		Antonyms:meager,scant,
corpulent	Synonyms:obese,portly,		Antonyms:gaunt,lank,emaciated,peaked,
cosmopolitan	Synonyms:Catholic,		Antonyms:parochial,provincial,
coterie	Synonyms:clique,	
countenance	Synonyms:visage,	
crass	Synonyms:gross,	
craven	Synonyms:pusillanimous,dastardly,		Antonyms:stalwart,intrepid,valiant,
credence	Synonyms:conviction,		Antonyms:skepticism,
credible	Antonyms:incredible,
creditable	Synonyms:praiseworthy,meritorious,commendable,		Antonyms:discreditable,infamous,opprobrious,ignominious,
credulous	Synonyms:gullible,		Antonyms:incredulous,skeptical,
cringe	Synonyms:cower,flinch,fawn,truckle,wince,	
crucial	Synonyms:occult,enigmatic,		Antonyms:palpable,manifest,
culpable	Synonyms:censurable,reprehensible,	
cumbrous	Synonyms:cumbersome,unwieldy,bulk,	
cursory	Synonyms:blunt,brusque,bluff,		Antonyms:painstaking,meticulous,brusque,bluff,
cynical	Synonyms:sarcastic,surly,	
dearth	Antonyms:plethora,abundance,
deference	Synonyms:respect,complaisance,veneration,	
deity	Synonyms:divinity,	
delectable	Synonyms:expunge,censor,efface,eradicate,	
delinquent	Synonyms:derelict,	
demeanor	Synonyms:deportment,mien,	
demure	Synonyms:sedate,staid,decorous,prudish,coy,		Antonyms:immodest,frivolous,
denounce	Synonyms:stigmatize,censure,reprehend,		Antonyms:laud,eulogize,
deplete	Synonyms:exhaust,drain,		Antonyms:replenish,
deplore	Synonyms:lament,decry,grieve,	
depraved	Synonyms:debased,wicked,vicious,perverted,	
deprecate	Synonyms:remonstrate,protest,decry,expostulate,		Antonyms:sanction,
depreciate	Synonyms:disparage,derogate,		Antonyms:enhance,magnify,extol,laud,eulogize,
devastation	Synonyms:destruction,desolation,	
devious	Synonyms:circuitous,	
devoid	Synonyms:destitute,		Antonyms:abounding,prevalent,
devout	Synonyms:pious,religious,	
didactic	Synonyms:pedagogical,	
diffident	Synonyms:shy,timid,reserved,reticent,retiring,		Antonyms:forward,aggressive,
dilemma	Synonyms:predicament,quandary,plight,	
dilettante	Synonyms:amateur,connoisseur,	
disconcert	Synonyms:perturb,discomfit,discompose,abash,disquiet,fluster,	
disconsolate	Synonyms:inconsolable,dejected,		Antonyms:blithesome,carefree,
discursive	Synonyms:desultory,digressive,	
dispassionate	Synonyms:palm,impartial,	
dispatch	Synonyms:expedite,	
dispel	Synonyms:dissipate,disperse,diffuse,	
dissolute	Synonyms:debauched,dissipated,profligate,	
distraught	Synonyms:harassed,	
diverse	Synonyms:multifarious,	
divulge	Synonyms:disclose,impart,	
dogmatic	Synonyms:overbearing,opinionated,peremptory,dictatorial,	
dolorous	Synonyms:doleful,lugubrious,grievous,		Antonyms:jocund,blithe,mirthful,
dynamic	Synonyms:energetic,		Antonyms:static,inert,dormant,torpid,sluggish,quiescent,
ecclesiastic	Antonyms:secular,lay,
edict	Synonyms:decree,	
egotistic	Synonyms:egocentric,vain,		Antonyms:altruistic,
elicit	Synonyms:evoke,extract,extort,	
elucidate	Synonyms:clarify,	
entreat	Synonyms:solicit,supplicate,beseech,implore,importune,	
ephemeral	Synonyms:fleeting,transitory,transient,evanescent,		Antonyms:eternal,
epigram	Synonyms:maxim proverb,adage,	
epithet	Synonyms:characterization,appellation,	
equanimity	Synonyms:serenity,composure,imperturbability,aplomb,	
err	Synonyms:stray,blunder,	
erudite	Synonyms:scholarly,knowing,	
esoteric	Synonyms:abstruse,recondite,	
exceptionable	Synonyms:questionable,reprehensible,censurable,		Antonyms:laudable,
exculpate	Synonyms:vindicate,exonerate,absolve,acquit,		Antonyms:arraign,indict,inculpate,
exemplary	Synonyms:illustrative,typical,laudable,	
expatiate	Synonyms:dilate,	
expedient	Synonyms:opportune,seasonable,	
exploit	Synonyms:feat,	
expurgate	Synonyms:purge,delete,	
extemporaneous	Synonyms:impromptu,offhand,	
extinct	Synonyms:defunct,		Antonyms:extant,
extirpate	Synonyms:eradicate,exterminate,efface,obliterate,	
extraneous.	Synonyms:extrinsic,adventitious,		Antonyms:germane,intrinsic,inherent,relevant,pertinent,
exultation	Synonyms:jubilation,	
facetious	Synonyms:jocose,droll,flippant,frivolous,		Antonyms:solemn,grave,saturnine,
fallible	Antonyms:infallible,unerring,
fatuous	Synonyms:inane,vacuous,puerile,		Antonyms:judicious,sagacious,sage,
fealty	Synonyms:allegiance,constancy,fidelity,		Antonyms:disloyalty,infidelity,treachery,
feasible	Antonyms:impracticable,
feign	Synonyms:dissemble,sham,dissimulate,affect,	
felicity	Synonyms:bliss,	
fervid	Synonyms:perfervid,impassioned,zealous,fervent,vehement,	
fetish	Synonyms:charm,talisman,amulet,	
fiasco	Synonyms:debacle,	
fictitious	Synonyms:fabricated,	
flaccid	Synonyms:flabby,limp,	
flagrant	Synonyms:glaring,scandalous,notorious,conspicuous,gross,	
flamboyant	Synonyms:florid,ornate,resplendent,embellished,garish,gaudy,gorgeous,rococo,		Antonyms:somber,
fleeting	Synonyms:transitory,fugitive,	
fluctuate	Synonyms:oscillate,vacillate,undulate,sway,	
forbear	Synonyms:restrain,abstain,	
forensic	Synonyms:rhetorical,oratorical,	
fortuitous	Synonyms:casual,incidental,adventitious,random,	
fracas	Synonyms:brawl,altercation,fray,wrangle,imbroglio,	
frustrate	Synonyms:balk,thwart,foil,baffle,obstruct,discomfit,		Antonyms:abet,
garnish	Synonyms:adorn,deck,	
genealogy	Synonyms:lineage,	
genesis	Synonyms:inception,	
ghastly	Synonyms:gruesome,grisly,pallid,macabre,grim,lurid,	
gibe	Synonyms:mock,sneer,jeer,scoff,flout,deride,	
gluttonous	Synonyms:voracious,intemperate,	
gossamer	Synonyms:diaphanous,flimsy,gauzelike Antonyms,ponderous,		Antonyms:substantial,ponderous,
gregarious	Antonyms:lone,aloof,
hail	Synonyms:accost,salute,	
harangue	Synonyms:tirade,	
harbinger,	Synonyms:precursor,herald,	
heedless	Synonyms:inadvertent,rash,incautious,		Antonyms:prudent,circumspect,mindful,wary,
heinous	Synonyms:atrocious,outrageous,monstrous,odious,nefarious,abominable,	
heresy	Synonyms:heterodoxy,		Antonyms:orthodoxy,
hiatus	Synonyms:breach,	
histrionic	Synonyms:dramatic,theatrical,	
hoax	Synonyms:canard,	
hyperbole	Synonyms:overstatement,		Antonyms:understatement,
hypothesis	Synonyms:supposition,	
idiosyncrasy	Synonyms:eccentricity,foible,mannerism,crotchet,aberration,quirk,singularity,	
ignominious	Synonyms:infamous,degrading,opprobrious,odious,		Antonyms:illustrious,renowned,preeminent,
immaculate	Synonyms:undefiled,unsullied,unblemished,untarnished,		Antonyms:defiled,sullied,blemished,
imminent	Synonyms:impending,	
immune	Synonyms:unsusceptible,	
impeach	Synonyms:arraign,	
impeccable	Synonyms:consummate,irreproachable,unerring,infallible,		Antonyms:culpable,fallible,
impervious	Synonyms:impermeable,impenetrable,		Antonyms:permeable,pervasive,
implacable	Synonyms:unrelenting,inexorable,unappeasable,		Antonyms:placable,forbearing,
implicit	Synonyms:tacit,implied,		Antonyms:explicit,
import	Synonyms:purport,moment,consequence,	
impostor	Synonyms:quack,mountebank,charlatan,bogus,fraud,	
imprecation	Synonyms:execration,malediction,anathema,		Antonyms:benediction,benison,
impregnable	Synonyms:invincible,		Antonyms:vulnerable,
impropriety	Synonyms:indecency,indecorum,		Antonyms:amenity,
improvident	Synonyms:prodigal,shiftless,	
incarcerate	Synonyms:intern,immure,		Antonyms:emancipate,enfranchise,
incisive	Synonyms:sarcastic,mordant,trenchant,acute,	
incontrovertible	Synonyms:irrefutable,indubitable,	
increment	Synonyms:accrual,	
incumbent	Synonyms:mandatory,imperative,	
indefatigable	Synonyms:unflagging,unremitting,persevering,	
indigenous	Synonyms:innate,inborn,	
indoomitable	Synonyms:insuperable,irrepressible,invincible,unyielding,		Antonyms:tractable,amenable,docile,submissive,
inference	Synonyms:deduction,implication,	
ingenious	Synonyms:dextrous,inventive,adroit,		Antonyms:maladroit,gauche,
ingenuous	Synonyms:unsophisticated,naive,candid,		Antonyms:sophisticated,
inhibit	Synonyms:restrain,curb,		Antonyms:promote,
innuendo	Synonyms:intimate,insinuate,	
inordinate	Synonyms:immoderate,intemperate,extravagant,	
inscrutable	Synonyms:unfathomable,cryptic,enigmatic,	
insidious	Synonyms:wily,crafty,furtive,treacherous,artful,guileful perfidious,	
instigate	Synonyms:foment,incite,	
integrity	Synonyms:probity,uprightness,incorruptibility,	
inveigh	Synonyms:rail,denounce,fulminate,vituperate,	
irascible	Synonyms:choleric,petulant,testy,peevish,splenetic,touchy,		Antonyms:placid,equable,
ire	Synonyms:resentment,	
itinerant	Synonyms:nomadic,	
jargon	Synonyms:gibberish,argot,cant,	
jaunty	Synonyms:sprightly,airy,gay,nonchalant,debonair,		Antonyms:somber,staid,
jeopardy	Synonyms:hazard,peril,	
judicious	Synonyms:discreet,politic,discerning,	
ken	Synonyms:insight,	
labyrinth	Synonyms:maze,	
laconic	Synonyms:concise,pithy,terse,succinct,taciturn,reticent,		Antonyms:verbose,prolix,redundant,diffuse,tautological,turgid,garrulous,voluble,
latent	Synonyms:dormant,quiescent,covert,potential,		Antonyms:apparent,patent,
lavish	Synonyms:ample,superabundant,		Antonyms:parsimonious,niggardly,frugal,penurious,
lethal	Synonyms:mortal,fatal,	
low	Synonyms:moo,	
lucid	Synonyms:pellucid,perspicuous,intelligible,limpid,luminous,translucent,		Antonyms:abstruse,obscure,
ludicrous	Synonyms:mirthful,droll,comical,absurd,		Antonyms:doleful,lugubrious,dismal,
machiavellian	Synonyms:unscrupulous,	
malicious	Synonyms:rancorous,malignant,malevolent,virulent,vindictive,		Antonyms:benign,
masquerade	Synonyms:dissemble,feign,	
maudlin	Synonyms:mawkish,lachrymose,	
meander	Synonyms:ramble,	
mercenary	Synonyms:venal,	
meretricious	Synonyms:tawdry,specious,	
meticulous	Synonyms:fastidious,punctilious,overscrupulous,finical,methodical,		Antonyms:desultory,perfunctory,slovenly,
mettle	Synonyms:temperament,ardor,	
misanthropic	Antonyms:philanthropic,altruistic,
monologue	Synonyms:soliloquy,		Antonyms:colloquy,
morose	Synonyms:sulky,crabbed,sullen,splenetic,saturnine,		Antonyms:blithe,genial,
motley	Synonyms:checkered,piebald,variegated,diverse,heterogeneous,		Antonyms:homogeneous,
mottled	Synonyms:blotched,dappled,	
mundane	Synonyms:earthly,terrestrial,secular,temporal,	
murky	Synonyms:dismal,tenebrous,fuliginous,		Antonyms:resplendent,glowing,lustrous,luminous,fulgent,coruscating,
mutable	Synonyms:vacillating,fickle,inconstant,fitful,mercurial,wavering,capricious,		Antonyms:constant,steady,
nautical	Synonyms:marine,naval,maritime,	
nettle	Synonyms:vex,pique,goad,	
nocturnal	Antonyms:diurnal,
noisome	Synonyms:malodorous,fetid,disgusting,deleterious,		Antonyms:salubrious,
nonchalant	Synonyms:apathetic,		Antonyms:enthusiastic,zealous,
novice	Synonyms:tyro,neophyte,		Antonyms:virtuoso,
obdurate	Synonyms:adamant,unyielding,inflexible,		Antonyms:submissive,docile,compliant,
oblivious	Synonyms:unmindful,heedless,abstracted,	
obsession	Synonyms:mania,infatuation,monomania,	
obsolete	Synonyms:archaic,antiquated,	
obtrusive	Synonyms:intrusive,aggressive,	
obviate	Synonyms:preclude,forestall,	
ostensible	Synonyms:professed,plausible,appearing true,reasonable,specious,	
ostracize	Synonyms:outlaw,	
panacea	Synonyms:nostrum,	
panegyric	Synonyms:eulogy,adulation,tribute,laudation,		Antonyms:censure,disparagement,derogation,castigation,depreciation,
paradox	Synonyms:anomaly,	
parody	Synonyms:burlesque,	
peccadillo	Synonyms:frailty,foible,flaw,blemish,	
pensive	Synonyms:reflective,meditative,contemplative,musing,	
peremptory	Synonyms:decisive,resolute,imperious,positive,dogmatic,		Antonyms:indecisive,tentative,
pertinacious	Synonyms:obdurate,tenacious,persistent,persevering,intractable,inflexible,	
perverse	Synonyms:headstrong,froward,refractory,wayward,fractious,	
petrify	Synonyms:stupefy,stun,bewilder,amaze,	
platitude	Synonyms:bromide,truism,axiom,	
plebeian	Antonyms:patrician,aristocratic,
prelude	Synonyms:preface,prologue,preamble,		Antonyms:epilogue,
prerogative	Synonyms:license,	
prestige	Synonyms:distinction,	
presumption	Synonyms:effrontery,forwardness,arrogance,	
prevaricate	Synonyms:quibble,equivocate,		Antonyms:veracity,verity,
procrastinate	Synonyms:defer,delay,	
prognosticate	Synonyms:presage,portend,augur,forebode,	
promontory	Synonyms:headland,precipice,	
promulgate	Synonyms:disseminate,	
protuberant	Antonyms:receding,recessive,
provisional	Synonyms:tentative,	
proximity	Synonyms:propinquity,vicinity,	
pseudonym	Synonyms:alias,pen name,nom de plume,	
quash	Synonyms:suppress,extinguish,quell,	
querulous	Synonyms:fretful,whining,captious,carping,peevish,petulant,		Antonyms:affable,
quixotic	Synonyms:utopian,visionary,fantastic,	
raze	Synonyms:level,		Antonyms:rear,
redolent	Synonyms:aromatic,	
redoubtable	Synonyms:formidable,	
refute	Synonyms:rebut,confute,		Antonyms:substantiate,confirm,corroborate,
remunerative	Synonyms:lucrative,gainful,	
renegade	Synonyms:turncoat,apostate,recreant,traitor,	
reprisal	Synonyms:retaliation,	
resentment	Synonyms:umbrage,dudgeon,animosity,	
resilient	Synonyms:flexible,pliable,supple,limber,	
respite	Synonyms:surcease,	
retribution	Synonyms:requital,nemesis,	
reverberate	Synonyms:resound,	
rudimentary	Synonyms:incipient,	
rue	Synonyms:regret,repent,	
sacrosanct	Synonyms:consecrated,inviolable,hallowed,	
sagacious	Synonyms:perspicacious,astute,sapient,discerning,sage,	
sallow	Synonyms:pallid,		Antonyms:rubicund,ruddy,florid,
sally	Synonyms:quip,banter,	
sanguinary	Synonyms:gory,	
sanguine	Synonyms:buoyant,ardent,	
satellite	Synonyms:lackey,toady,disciple,adherent,	
scintilla	Synonyms:iota,	
scourge	Synonyms:tribulation,	
simper	Synonyms:smirk,	
sleazy	Synonyms:unsubstantial,	
slovenly	Synonyms:slipshod,slatternly,frowzy,	
sordid	Synonyms:degraded,vile,ignoble,	
sovereign	Synonyms:autonomous,imperial,majestic,paramount,	
spurn	Synonyms:repel,snub,	
stoic	Synonyms:stolid,impassive,	
stringent	Synonyms:exacting,rigid,		Antonyms:lax,
stupendous	Synonyms:astounding,prodigious,monstrous,marvelous,colossal,awful,	
succulent	Antonyms:desiccated,vapid,
supine	Synonyms:listless,torpid,		Antonyms:erect,inactive,
tangible	Synonyms:material,veritable,perceptible,substantial,	
taunt	Synonyms:mock,twit,gibe,sneer,deride,	
teeming	Synonyms:swarming,fruitful,fecund,abounding,	
temerity	Synonyms:audacity,presumptuousness,effrontery,rashness,		Antonyms:prudence,circumspection,wariness,
temporal	Synonyms:mundane,secular,civil,	
temporize	Synonyms:equivocate,	
tenet	Synonyms:creed,doctrine,dogma,	
tranquil	Synonyms:placid,serene,		Antonyms:perturbed,ruffled,turbulent,
tremulous	Synonyms:quivering,	
trivial	Synonyms:paltry,		Antonyms:gross,momentous,
turgid	Synonyms:bloated,distended,	
ubiquitous	Synonyms:omnipresent,universal,	
vaunt	Synonyms:brag,proclaim,	
veneer	Synonyms:gloss,	
vernal	Antonyms:hibernal,
virago	Synonyms:shrew,termagant,vixen,	
vituperate	Synonyms:berate,revile,	
waive	Synonyms:relinquish,forgo,forsake,	
whim	Synonyms:caprice,vagary,crotchet,	
writhe	Synonyms:contort,squirm,	
zealous	Antonyms:perfunctory,
zenith	Synonyms:acme,apex,culmination,summit,		Antonyms:nadir,
